[console_scripts]
cmsAdaptContest = cmstestsuite.AdaptContest:main
cmsAddAdmin = cmscontrib.AddAdmin:main
cmsAddParticipation = cmscontrib.AddParticipation:main
cmsAddStatement = cmscontrib.AddStatement:main
cmsAddSubmission = cmscontrib.AddSubmission:main
cmsAddTeam = cmscontrib.AddTeam:main
cmsAddTestcases = cmscontrib.AddTestcases:main
cmsAddUser = cmscontrib.AddUser:main
cmsCleanFiles = cmscontrib.CleanFiles:main
cmsComputeComplexity = cmscontrib.ComputeComplexity:main
cmsDumpExporter = cmscontrib.DumpExporter:main
cmsDumpImporter = cmscontrib.DumpImporter:main
cmsDumpUpdater = cmscontrib.DumpUpdater:main
cmsExportSubmissions = cmscontrib.ExportSubmissions:main
cmsImportContest = cmscontrib.ImportContest:main
cmsImportDataset = cmscontrib.ImportDataset:main
cmsImportTask = cmscontrib.ImportTask:main
cmsImportTeam = cmscontrib.ImportTeam:main
cmsImportUser = cmscontrib.ImportUser:main
cmsMake = cmstaskenv.cmsMake:main
cmsRWSHelper = cmscontrib.RWSHelper:main
cmsRemoveContest = cmscontrib.RemoveContest:main
cmsRemoveParticipation = cmscontrib.RemoveParticipation:main
cmsRemoveSubmissions = cmscontrib.RemoveSubmissions:main
cmsRemoveTask = cmscontrib.RemoveTask:main
cmsRemoveUser = cmscontrib.RemoveUser:main
cmsReplayContest = cmstestsuite.ReplayContest:main
cmsRunTests = cmstestsuite.RunTests:main
cmsSpoolExporter = cmscontrib.SpoolExporter:main
cmsTestFileCacher = cmstestsuite.TestFileCacher:main
cmsYamlImporter = cmscompat.YamlImporter:main
cmsYamlReimporter = cmscompat.YamlReimporter:main

